//MAP CONVERTED BY dmm2tgm.py THIS HEADER COMMENT PREVENTS RECONVERSION, DO NOT REMOVE
"a" = (
/turf/open/indestructible/white/smooth_large,
/area/deathmatch)
"b" = (
/obj/structure/closet/secure_closet{
	req_access = list("armory")
	},
/obj/effect/spawner/random/exotic/antag_gear,
/obj/machinery/light/warm/directional/south,
/turf/open/indestructible/hotelwood,
/area/deathmatch)
"d" = (
/obj/structure/table/wood,
/obj/effect/decal/cleanable/dirt,
/obj/effect/spawner/random/contraband/permabrig_weapon,
/turf/open/indestructible/hotelwood,
/area/deathmatch)
"e" = (
/obj/machinery/light/warm/directional/north,
/turf/open/indestructible/hotelwood,
/area/deathmatch)
"f" = (
/obj/machinery/light/warm/directional/south,
/turf/open/indestructible/hotelwood,
/area/deathmatch)
"h" = (
/turf/closed/indestructible/fakedoor,
/area/deathmatch)
"i" = (
/obj/effect/landmark/deathmatch_player_spawn,
/obj/item/clothing/suit/jacket/straight_jacket,
/turf/open/indestructible/white/smooth_large,
/area/deathmatch)
"k" = (
/obj/structure/table/wood,
/obj/effect/spawner/random/contraband/permabrig_weapon,
/turf/open/indestructible/hotelwood,
/area/deathmatch)
"l" = (
/obj/structure/table/wood,
/turf/open/indestructible/hotelwood,
/area/deathmatch)
"q" = (
/obj/effect/decal/cleanable/dirt/dust,
/turf/open/indestructible/hotelwood,
/area/deathmatch)
"s" = (
/obj/effect/landmark/deathmatch_player_spawn,
/turf/open/indestructible/white/smooth_large,
/area/deathmatch)
"u" = (
/obj/effect/decal/cleanable/dirt/dust,
/obj/machinery/light/cold/directional/south,
/turf/open/indestructible/white/smooth_large,
/area/deathmatch)
"w" = (
/turf/closed/indestructible/oldshuttle,
/area/deathmatch)
"x" = (
/turf/open/indestructible/hotelwood,
/area/deathmatch)
"A" = (
/obj/effect/spawner/random/bureaucracy/crayon,
/turf/open/indestructible/white/smooth_large,
/area/deathmatch)
"C" = (
/mob/living/basic/clown/clownhulk/chlown,
/obj/machinery/light/warm/directional/south,
/obj/structure/closet/toolcloset,
/obj/item/stack/sheet/glass,
/obj/item/stack/rods,
/obj/item/restraints/handcuffs/cable/yellow,
/turf/open/indestructible/hotelwood,
/area/deathmatch)
"G" = (
/turf/closed/indestructible/wood,
/area/deathmatch)
"H" = (
/obj/effect/spawner/random/exotic/antag_gear_weak,
/obj/item/clothing/suit/jacket/straight_jacket,
/turf/open/indestructible/white/smooth_large,
/area/deathmatch)
"I" = (
/obj/effect/spawner/random/exotic/antag_gear_weak,
/turf/open/indestructible/white/smooth_large,
/area/deathmatch)
"J" = (
/obj/item/shard,
/turf/open/indestructible/hotelwood,
/area/deathmatch)
"K" = (
/obj/structure/closet/secure_closet{
	req_access = list("armory")
	},
/obj/effect/spawner/random/exotic/antag_gear,
/turf/open/indestructible/hotelwood,
/area/deathmatch)
"L" = (
/obj/item/clothing/suit/jacket/straight_jacket,
/turf/open/indestructible/white/smooth_large,
/area/deathmatch)
"M" = (
/obj/effect/decal/cleanable/crayon,
/turf/open/indestructible/white/smooth_large,
/area/deathmatch)
"N" = (
/obj/effect/decal/cleanable/dirt,
/turf/open/indestructible/hotelwood,
/area/deathmatch)
"O" = (
/obj/machinery/light/cold/directional/north,
/turf/open/indestructible/white/smooth_large,
/area/deathmatch)
"S" = (
/obj/effect/decal/cleanable/dirt/dust,
/obj/structure/closet/toolcloset,
/mob/living/basic/clown/mutant,
/turf/open/indestructible/hotelwood,
/area/deathmatch)
"T" = (
/obj/machinery/door/airlock/silver/glass,
/turf/open/indestructible/white/smooth_large,
/area/deathmatch)
"U" = (
/obj/effect/decal/cleanable/dirt/dust,
/turf/open/indestructible/white/smooth_large,
/area/deathmatch)
"V" = (
/obj/machinery/light/cold/directional/south,
/turf/open/indestructible/white/smooth_large,
/area/deathmatch)
"W" = (
/obj/structure/table/wood,
/obj/machinery/light/warm/directional/north,
/turf/open/indestructible/hotelwood,
/area/deathmatch)

(1,1,1) = {"
w
w
w
w
w
w
w
G
G
h
h
G
G
w
w
w
w
w
w
w
"}
(2,1,1) = {"
w
a
a
a
a
a
w
G
S
q
x
f
G
w
a
a
U
U
a
w
"}
(3,1,1) = {"
w
a
a
A
M
a
w
G
q
x
x
x
G
w
a
a
a
a
U
w
"}
(4,1,1) = {"
w
O
a
s
a
a
U
T
x
x
x
x
T
a
a
a
i
a
V
w
"}
(5,1,1) = {"
w
a
M
a
L
M
w
G
x
x
J
N
G
w
U
a
U
a
a
w
"}
(6,1,1) = {"
w
a
a
a
a
U
w
G
W
x
x
q
G
w
U
I
a
a
a
w
"}
(7,1,1) = {"
w
w
w
w
w
w
w
G
d
x
x
q
G
w
w
w
w
w
w
w
"}
(8,1,1) = {"
w
U
U
a
a
a
w
G
K
x
x
f
G
w
U
U
a
a
a
w
"}
(9,1,1) = {"
w
U
a
a
a
a
w
G
q
x
x
x
G
w
a
a
L
a
a
w
"}
(10,1,1) = {"
w
O
a
i
a
a
a
T
q
x
x
x
T
U
a
a
s
a
V
w
"}
(11,1,1) = {"
w
a
a
a
U
a
w
G
x
x
x
N
G
w
a
a
a
a
U
w
"}
(12,1,1) = {"
w
a
a
a
a
a
w
G
x
x
x
b
G
w
U
a
a
U
U
w
"}
(13,1,1) = {"
w
w
w
w
w
w
w
G
x
x
x
l
G
w
w
w
w
w
w
w
"}
(14,1,1) = {"
w
U
U
a
a
U
w
G
e
x
x
k
G
w
U
a
U
U
a
w
"}
(15,1,1) = {"
w
a
a
a
a
a
w
G
x
x
x
x
G
w
U
a
a
a
U
w
"}
(16,1,1) = {"
w
O
a
s
a
a
U
T
x
x
x
x
T
a
a
a
s
a
u
w
"}
(17,1,1) = {"
w
a
H
a
a
a
w
G
x
x
x
x
G
w
a
L
a
U
a
w
"}
(18,1,1) = {"
w
a
U
U
U
a
w
G
q
q
x
C
G
w
a
a
U
U
a
w
"}
(19,1,1) = {"
w
w
w
w
w
w
w
G
G
h
h
G
G
w
w
w
w
w
w
w
"}
