//MAP CONVERTED BY dmm2tgm.py THIS HEADER COMMENT PREVENTS RECONVERSION, DO NOT REMOVE
"a" = (
/turf/closed/wall/mineral/titanium,
/area/shuttle/supply)
"d" = (
/obj/effect/spawner/structure/window/reinforced/shuttle,
/obj/machinery/power/shuttle_engine/heater,
/turf/open/floor/plating,
/area/shuttle/supply)
"f" = (
/obj/machinery/power/shuttle_engine/propulsion,
/obj/effect/turf_decal/stripes/line{
	dir = 1
	},
/obj/effect/turf_decal/stripes/line,
/turf/open/floor/plating,
/area/shuttle/supply)
"h" = (
/obj/machinery/door/poddoor{
	id = "QMLoaddoor";
	name = "Supply Dock Loading Door"
	},
/turf/open/floor/plating,
/area/shuttle/supply)
"i" = (
/obj/machinery/button/door/directional/west{
	id = "QMLoaddoor2";
	name = "On Ramp Toggle";
	pixel_y = -7;
	req_access = list("cargo");
	pixel_x = 26
	},
/obj/machinery/button/door/directional/west{
	id = "QMLoaddoor";
	name = "Off Ramp Toggle";
	pixel_y = 6;
	req_access = list("cargo");
	pixel_x = 26
	},
/obj/effect/turf_decal/siding/yellow{
	dir = 4
	},
/turf/open/floor/mineral/titanium/yellow,
/area/shuttle/supply)
"n" = (
/obj/machinery/door/airlock/shuttle{
	name = "Supply Shuttle Airlock"
	},
/obj/effect/mapping_helpers/airlock/access/all/supply/general,
/obj/docking_port/mobile/supply,
/turf/open/floor/plating,
/area/shuttle/supply)
"o" = (
/obj/machinery/door/poddoor{
	id = "QMLoaddoor2";
	name = "Supply Dock Loading Door"
	},
/turf/open/floor/plating,
/area/shuttle/supply)
"q" = (
/turf/closed/wall/mineral/titanium/nodiagonal,
/area/shuttle/supply)
"s" = (
/obj/effect/turf_decal/siding/yellow{
	dir = 8
	},
/obj/effect/turf_decal/stripes/corner{
	dir = 4
	},
/obj/machinery/light/directional/west,
/turf/open/floor/mineral/titanium/yellow,
/area/shuttle/supply)
"t" = (
/turf/closed/wall/mineral/plastitanium/nodiagonal,
/area/shuttle/supply)
"z" = (
/obj/effect/turf_decal/loading_area{
	dir = 8
	},
/turf/open/floor/mineral/plastitanium,
/area/shuttle/supply)
"A" = (
/obj/effect/turf_decal/siding/yellow{
	dir = 8
	},
/obj/effect/turf_decal/stripes/corner,
/obj/machinery/light/directional/west,
/turf/open/floor/mineral/titanium/yellow,
/area/shuttle/supply)
"B" = (
/obj/effect/turf_decal/siding/yellow{
	dir = 4
	},
/obj/effect/turf_decal/stripes/line,
/turf/open/floor/mineral/titanium/yellow,
/area/shuttle/supply)
"C" = (
/obj/effect/turf_decal/siding/yellow{
	dir = 4
	},
/obj/effect/turf_decal/stripes/line{
	dir = 1
	},
/turf/open/floor/mineral/titanium/yellow,
/area/shuttle/supply)
"D" = (
/obj/machinery/door/airlock/shuttle{
	name = "Supply Shuttle Airlock"
	},
/obj/effect/mapping_helpers/airlock/access/all/supply/general,
/turf/open/floor/plating,
/area/shuttle/supply)
"F" = (
/obj/effect/turf_decal/loading_area{
	dir = 4
	},
/turf/open/floor/mineral/plastitanium,
/area/shuttle/supply)
"H" = (
/obj/effect/turf_decal/siding/yellow{
	dir = 9
	},
/obj/structure/sign/departments/cargo/directional/west,
/obj/effect/turf_decal/stripes/corner,
/obj/effect/turf_decal/stripes/corner{
	dir = 4
	},
/turf/open/floor/mineral/titanium/yellow,
/area/shuttle/supply)
"K" = (
/obj/effect/turf_decal/siding/yellow{
	dir = 8
	},
/turf/open/floor/mineral/titanium/yellow,
/area/shuttle/supply)
"S" = (
/obj/effect/turf_decal/siding/yellow{
	dir = 10
	},
/obj/structure/sign/departments/cargo/directional/west,
/obj/effect/turf_decal/stripes/corner{
	dir = 4
	},
/obj/effect/turf_decal/stripes/corner,
/turf/open/floor/mineral/titanium/yellow,
/area/shuttle/supply)
"V" = (
/obj/machinery/power/shuttle_engine/heater,
/obj/effect/spawner/structure/window/reinforced/shuttle,
/turf/open/floor/plating,
/area/shuttle/supply)
"Y" = (
/turf/closed/wall/mineral/plastitanium,
/area/shuttle/supply)

(1,1,1) = {"
q
a
a
a
a
a
t
Y
"}
(2,1,1) = {"
a
H
s
K
A
S
d
f
"}
(3,1,1) = {"
a
F
C
i
B
z
V
f
"}
(4,1,1) = {"
q
h
D
a
n
o
t
Y
"}
