//MAP CONVERTED BY dmm2tgm.py THIS HEADER COMMENT PREVENTS RECONVERSION, DO NOT REMOVE
"a" = (
/obj/effect/turf_decal/stripes/line,
/obj/effect/turf_decal/siding/dark{
	dir = 6
	},
/obj/effect/turf_decal/box/corners,
/obj/effect/turf_decal/tile/neutral/opposingcorners,
/obj/effect/turf_decal/trimline/neutral/warning{
	dir = 4
	},
/turf/open/floor/mineral/titanium/yellow,
/area/shuttle/mining)
"s" = (
/obj/structure/table,
/obj/effect/turf_decal/siding/dark{
	dir = 6
	},
/obj/item/storage/medkit/regular{
	pixel_x = -3;
	pixel_y = 2
	},
/obj/item/storage/toolbox/emergency{
	pixel_x = 4;
	pixel_y = 2
	},
/obj/item/radio{
	pixel_x = 6;
	pixel_y = 6
	},
/turf/open/floor/mineral/plastitanium,
/area/shuttle/mining)
"t" = (
/obj/machinery/door/airlock/titanium{
	name = "Mining Shuttle Airlock"
	},
/obj/effect/turf_decal/siding/dark/end{
	dir = 4
	},
/obj/docking_port/mobile{
	dir = 8;
	shuttle_id = "mining";
	name = "mining shuttle";
	port_direction = 4
	},
/turf/open/floor/mineral/plastitanium,
/area/shuttle/mining)
"w" = (
/obj/structure/chair/comfy/shuttle{
	dir = 1
	},
/obj/effect/turf_decal/stripes/line{
	dir = 1
	},
/obj/effect/turf_decal/siding/dark{
	dir = 9
	},
/obj/effect/turf_decal/box/corners{
	dir = 1
	},
/obj/effect/turf_decal/tile/neutral/opposingcorners,
/obj/effect/turf_decal/trimline/neutral/warning{
	dir = 8
	},
/turf/open/floor/mineral/titanium/yellow,
/area/shuttle/mining)
"D" = (
/obj/effect/turf_decal/stripes/line,
/obj/effect/turf_decal/siding/dark{
	dir = 10
	},
/obj/effect/turf_decal/box/corners{
	dir = 8
	},
/obj/effect/turf_decal/tile/neutral/opposingcorners,
/obj/effect/turf_decal/trimline/neutral/warning{
	dir = 8
	},
/turf/open/floor/mineral/titanium/yellow,
/area/shuttle/mining)
"H" = (
/obj/machinery/power/shuttle_engine/propulsion,
/turf/open/floor/plating,
/area/shuttle/mining)
"J" = (
/obj/machinery/power/shuttle_engine/heater,
/obj/effect/spawner/structure/window/reinforced/shuttle,
/turf/open/floor/plating,
/area/shuttle/mining)
"L" = (
/turf/closed/wall/mineral/plastitanium,
/area/shuttle/mining)
"N" = (
/obj/effect/turf_decal/stripes/line{
	dir = 1
	},
/obj/effect/turf_decal/siding/dark{
	dir = 5
	},
/obj/effect/turf_decal/box/corners{
	dir = 4
	},
/obj/effect/turf_decal/tile/neutral/opposingcorners,
/obj/effect/turf_decal/trimline/neutral/warning{
	dir = 4
	},
/obj/structure/chair/comfy/shuttle{
	dir = 1
	},
/turf/open/floor/mineral/titanium/yellow,
/area/shuttle/mining)
"O" = (
/obj/effect/spawner/structure/window/reinforced/shuttle,
/turf/open/floor/plating,
/area/shuttle/mining)
"Q" = (
/turf/closed/wall/mineral/titanium,
/area/shuttle/mining)
"S" = (
/obj/item/clothing/suit/hazardvest{
	desc = "A high-visibility lifejacket complete with whistle and slot for oxygen tanks.";
	name = "emergency lifejacket"
	},
/obj/item/clothing/suit/hazardvest{
	desc = "A high-visibility lifejacket complete with whistle and slot for oxygen tanks.";
	name = "emergency lifejacket"
	},
/obj/item/tank/internals/emergency_oxygen{
	pixel_x = 3
	},
/obj/item/tank/internals/emergency_oxygen{
	pixel_x = 3
	},
/obj/item/clothing/mask/breath{
	pixel_x = -3;
	pixel_y = -3
	},
/obj/item/clothing/mask/breath{
	pixel_x = -3;
	pixel_y = -3
	},
/obj/item/clothing/head/utility/hardhat/orange{
	name = "protective hat";
	pixel_y = 9
	},
/obj/item/clothing/head/utility/hardhat/orange{
	name = "protective hat";
	pixel_y = 9
	},
/obj/structure/closet/crate/internals,
/obj/effect/turf_decal/box,
/obj/effect/turf_decal/siding/dark{
	dir = 5
	},
/turf/open/floor/mineral/plastitanium,
/area/shuttle/mining)
"U" = (
/obj/machinery/computer/shuttle/mining,
/obj/effect/turf_decal/siding/dark{
	dir = 10
	},
/obj/effect/turf_decal/bot,
/turf/open/floor/mineral/plastitanium,
/area/shuttle/mining)
"W" = (
/obj/structure/ore_box,
/obj/effect/turf_decal/siding/dark{
	dir = 9
	},
/obj/effect/turf_decal/box,
/obj/machinery/light/directional/south,
/turf/open/floor/mineral/plastitanium,
/area/shuttle/mining)

(1,1,1) = {"
Q
O
O
Q
J
H
"}
(2,1,1) = {"
O
U
w
D
W
L
"}
(3,1,1) = {"
O
s
N
a
S
L
"}
(4,1,1) = {"
Q
O
t
Q
J
H
"}
